state_code,const_no,osn,cand_name,cand_party,evm_votes,post_votes,tot_votes,perc_votes
U05,1,1,NEEL DAMAN KHATRI,Bharatiya Janata Party,68244,589,68833,41.54
U05,1,2,MAHENDER CHAUDHARY,Bahujan Samaj Party,811,10,821,0.5
U05,1,3,SHARAD KUMAR,Aam Aadmi Party,86070,192,86262,52.06
U05,1,4,SIDDHARTH KUNDU,Indian National Congress,6240,30,6270,3.78
U05,1,5,CHAND RAM,Rastriya Aam Jan Seva Party,138,0,138,0.08
U05,1,6,NAR SINGH,Sarvajan Hitay Party,603,1,604,0.36
U05,1,7,RAMESH KUMAR,Bhartiya Samajik Nyay Party,104,1,105,0.06
U05,1,8,RAJBALA SAINI,Loktanter Suraksha Party,1077,5,1082,0.65
U05,1,9,SURESH KUMAR,Peoples Party of India (Democratic),180,0,180,0.11
U05,1,10,SULESH KUMAR,Aapki Apni Party (Peoples),495,0,495,0.3
U05,1,11,ADITI,Independent,151,0,151,0.09
U05,1,12,NOTA,None of the Above,746,7,753,0.45
U05,2,1,NEEL DAMAN KHATRI,Bharatiya Janata Party,68244,589,68833,41.54
U05,2,2,MAHENDER CHAUDHARY,Bahujan Samaj Party,811,10,821,0.5
U05,2,3,SHARAD KUMAR,Aam Aadmi Party,86070,192,86262,52.06
U05,2,4,SIDDHARTH KUNDU,Indian National Congress,6240,30,6270,3.78
U05,2,5,CHAND RAM,Rastriya Aam Jan Seva Party,138,0,138,0.08
U05,2,6,NAR SINGH,Sarvajan Hitay Party,603,1,604,0.36
U05,2,7,RAMESH KUMAR,Bhartiya Samajik Nyay Party,104,1,105,0.06
U05,2,8,RAJBALA SAINI,Loktanter Suraksha Party,1077,5,1082,0.65
U05,2,9,SURESH KUMAR,Peoples Party of India (Democratic),180,0,180,0.11
U05,2,10,SULESH KUMAR,Aapki Apni Party (Peoples),495,0,495,0.3
U05,2,11,ADITI,Independent,151,0,151,0.09
U05,2,12,NOTA,None of the Above,746,7,753,0.45
U05,3,1,NEEL DAMAN KHATRI,Bharatiya Janata Party,68244,589,68833,41.54
U05,3,2,MAHENDER CHAUDHARY,Bahujan Samaj Party,811,10,821,0.5
U05,3,3,SHARAD KUMAR,Aam Aadmi Party,86070,192,86262,52.06
U05,3,4,SIDDHARTH KUNDU,Indian National Congress,6240,30,6270,3.78
U05,3,5,CHAND RAM,Rastriya Aam Jan Seva Party,138,0,138,0.08
U05,3,6,NAR SINGH,Sarvajan Hitay Party,603,1,604,0.36
U05,3,7,RAMESH KUMAR,Bhartiya Samajik Nyay Party,104,1,105,0.06
U05,3,8,RAJBALA SAINI,Loktanter Suraksha Party,1077,5,1082,0.65
U05,3,9,SURESH KUMAR,Peoples Party of India (Democratic),180,0,180,0.11
U05,3,10,SULESH KUMAR,Aapki Apni Party (Peoples),495,0,495,0.3
U05,3,11,ADITI,Independent,151,0,151,0.09
U05,3,12,NOTA,None of the Above,746,7,753,0.45
U05,4,1,NEEL DAMAN KHATRI,Bharatiya Janata Party,68244,589,68833,41.54
U05,4,2,MAHENDER CHAUDHARY,Bahujan Samaj Party,811,10,821,0.5
U05,4,3,SHARAD KUMAR,Aam Aadmi Party,86070,192,86262,52.06
U05,4,4,SIDDHARTH KUNDU,Indian National Congress,6240,30,6270,3.78
U05,4,5,CHAND RAM,Rastriya Aam Jan Seva Party,138,0,138,0.08
U05,4,6,NAR SINGH,Sarvajan Hitay Party,603,1,604,0.36
U05,4,7,RAMESH KUMAR,Bhartiya Samajik Nyay Party,104,1,105,0.06
U05,4,8,RAJBALA SAINI,Loktanter Suraksha Party,1077,5,1082,0.65
U05,4,9,SURESH KUMAR,Peoples Party of India (Democratic),180,0,180,0.11
U05,4,10,SULESH KUMAR,Aapki Apni Party (Peoples),495,0,495,0.3
U05,4,11,ADITI,Independent,151,0,151,0.09
U05,4,12,NOTA,None of the Above,746,7,753,0.45
U05,5,1,NEEL DAMAN KHATRI,Bharatiya Janata Party,68244,589,68833,41.54
U05,5,2,MAHENDER CHAUDHARY,Bahujan Samaj Party,811,10,821,0.5
U05,5,3,SHARAD KUMAR,Aam Aadmi Party,86070,192,86262,52.06
U05,5,4,SIDDHARTH KUNDU,Indian National Congress,6240,30,6270,3.78
U05,5,5,CHAND RAM,Rastriya Aam Jan Seva Party,138,0,138,0.08
U05,5,6,NAR SINGH,Sarvajan Hitay Party,603,1,604,0.36
U05,5,7,RAMESH KUMAR,Bhartiya Samajik Nyay Party,104,1,105,0.06
U05,5,8,RAJBALA SAINI,Loktanter Suraksha Party,1077,5,1082,0.65
U05,5,9,SURESH KUMAR,Peoples Party of India (Democratic),180,0,180,0.11
U05,5,10,SULESH KUMAR,Aapki Apni Party (Peoples),495,0,495,0.3
U05,5,11,ADITI,Independent,151,0,151,0.09
U05,5,12,NOTA,None of the Above,746,7,753,0.45
U05,6,1,NEEL DAMAN KHATRI,Bharatiya Janata Party,68244,589,68833,41.54
U05,6,2,MAHENDER CHAUDHARY,Bahujan Samaj Party,811,10,821,0.5
U05,6,3,SHARAD KUMAR,Aam Aadmi Party,86070,192,86262,52.06
U05,6,4,SIDDHARTH KUNDU,Indian National Congress,6240,30,6270,3.78
U05,6,5,CHAND RAM,Rastriya Aam Jan Seva Party,138,0,138,0.08
U05,6,6,NAR SINGH,Sarvajan Hitay Party,603,1,604,0.36
U05,6,7,RAMESH KUMAR,Bhartiya Samajik Nyay Party,104,1,105,0.06
U05,6,8,RAJBALA SAINI,Loktanter Suraksha Party,1077,5,1082,0.65
U05,6,9,SURESH KUMAR,Peoples Party of India (Democratic),180,0,180,0.11
U05,6,10,SULESH KUMAR,Aapki Apni Party (Peoples),495,0,495,0.3
U05,6,11,ADITI,Independent,151,0,151,0.09
U05,6,12,NOTA,None of the Above,746,7,753,0.45
U05,7,1,NEEL DAMAN KHATRI,Bharatiya Janata Party,68244,589,68833,41.54
U05,7,2,MAHENDER CHAUDHARY,Bahujan Samaj Party,811,10,821,0.5
U05,7,3,SHARAD KUMAR,Aam Aadmi Party,86070,192,86262,52.06
U05,7,4,SIDDHARTH KUNDU,Indian National Congress,6240,30,6270,3.78
U05,7,5,CHAND RAM,Rastriya Aam Jan Seva Party,138,0,138,0.08
U05,7,6,NAR SINGH,Sarvajan Hitay Party,603,1,604,0.36
U05,7,7,RAMESH KUMAR,Bhartiya Samajik Nyay Party,104,1,105,0.06
U05,7,8,RAJBALA SAINI,Loktanter Suraksha Party,1077,5,1082,0.65
U05,7,9,SURESH KUMAR,Peoples Party of India (Democratic),180,0,180,0.11
U05,7,10,SULESH KUMAR,Aapki Apni Party (Peoples),495,0,495,0.3
U05,7,11,ADITI,Independent,151,0,151,0.09
U05,7,12,NOTA,None of the Above,746,7,753,0.45
U05,8,1,NEEL DAMAN KHATRI,Bharatiya Janata Party,68244,589,68833,41.54
U05,8,2,MAHENDER CHAUDHARY,Bahujan Samaj Party,811,10,821,0.5
U05,8,3,SHARAD KUMAR,Aam Aadmi Party,86070,192,86262,52.06
U05,8,4,SIDDHARTH KUNDU,Indian National Congress,6240,30,6270,3.78
U05,8,5,CHAND RAM,Rastriya Aam Jan Seva Party,138,0,138,0.08
U05,8,6,NAR SINGH,Sarvajan Hitay Party,603,1,604,0.36
U05,8,7,RAMESH KUMAR,Bhartiya Samajik Nyay Party,104,1,105,0.06
U05,8,8,RAJBALA SAINI,Loktanter Suraksha Party,1077,5,1082,0.65
U05,8,9,SURESH KUMAR,Peoples Party of India (Democratic),180,0,180,0.11
U05,8,10,SULESH KUMAR,Aapki Apni Party (Peoples),495,0,495,0.3
U05,8,11,ADITI,Independent,151,0,151,0.09
U05,8,12,NOTA,None of the Above,746,7,753,0.45
U05,9,1,NEEL DAMAN KHATRI,Bharatiya Janata Party,68244,589,68833,41.54
U05,9,2,MAHENDER CHAUDHARY,Bahujan Samaj Party,811,10,821,0.5
U05,9,3,SHARAD KUMAR,Aam Aadmi Party,86070,192,86262,52.06
U05,9,4,SIDDHARTH KUNDU,Indian National Congress,6240,30,6270,3.78
U05,9,5,CHAND RAM,Rastriya Aam Jan Seva Party,138,0,138,0.08
U05,9,6,NAR SINGH,Sarvajan Hitay Party,603,1,604,0.36
U05,9,7,RAMESH KUMAR,Bhartiya Samajik Nyay Party,104,1,105,0.06
U05,9,8,RAJBALA SAINI,Loktanter Suraksha Party,1077,5,1082,0.65
U05,9,9,SURESH KUMAR,Peoples Party of India (Democratic),180,0,180,0.11
U05,9,10,SULESH KUMAR,Aapki Apni Party (Peoples),495,0,495,0.3
U05,9,11,ADITI,Independent,151,0,151,0.09
U05,9,12,NOTA,None of the Above,746,7,753,0.45
U05,10,1,NEEL DAMAN KHATRI,Bharatiya Janata Party,68244,589,68833,41.54
U05,10,2,MAHENDER CHAUDHARY,Bahujan Samaj Party,811,10,821,0.5
U05,10,3,SHARAD KUMAR,Aam Aadmi Party,86070,192,86262,52.06
U05,10,4,SIDDHARTH KUNDU,Indian National Congress,6240,30,6270,3.78
U05,10,5,CHAND RAM,Rastriya Aam Jan Seva Party,138,0,138,0.08
U05,10,6,NAR SINGH,Sarvajan Hitay Party,603,1,604,0.36
U05,10,7,RAMESH KUMAR,Bhartiya Samajik Nyay Party,104,1,105,0.06
U05,10,8,RAJBALA SAINI,Loktanter Suraksha Party,1077,5,1082,0.65
U05,10,9,SURESH KUMAR,Peoples Party of India (Democratic),180,0,180,0.11
U05,10,10,SULESH KUMAR,Aapki Apni Party (Peoples),495,0,495,0.3
U05,10,11,ADITI,Independent,151,0,151,0.09
U05,10,12,NOTA,None of the Above,746,7,753,0.45
U05,11,1,NEEL DAMAN KHATRI,Bharatiya Janata Party,68244,589,68833,41.54
U05,11,2,MAHENDER CHAUDHARY,Bahujan Samaj Party,811,10,821,0.5
U05,11,3,SHARAD KUMAR,Aam Aadmi Party,86070,192,86262,52.06
U05,11,4,SIDDHARTH KUNDU,Indian National Congress,6240,30,6270,3.78
U05,11,5,CHAND RAM,Rastriya Aam Jan Seva Party,138,0,138,0.08
U05,11,6,NAR SINGH,Sarvajan Hitay Party,603,1,604,0.36
U05,11,7,RAMESH KUMAR,Bhartiya Samajik Nyay Party,104,1,105,0.06
U05,11,8,RAJBALA SAINI,Loktanter Suraksha Party,1077,5,1082,0.65
U05,11,9,SURESH KUMAR,Peoples Party of India (Democratic),180,0,180,0.11
U05,11,10,SULESH KUMAR,Aapki Apni Party (Peoples),495,0,495,0.3
U05,11,11,ADITI,Independent,151,0,151,0.09
U05,11,12,NOTA,None of the Above,746,7,753,0.45
U05,12,1,NEEL DAMAN KHATRI,Bharatiya Janata Party,68244,589,68833,41.54
U05,12,2,MAHENDER CHAUDHARY,Bahujan Samaj Party,811,10,821,0.5
U05,12,3,SHARAD KUMAR,Aam Aadmi Party,86070,192,86262,52.06
U05,12,4,SIDDHARTH KUNDU,Indian National Congress,6240,30,6270,3.78
U05,12,5,CHAND RAM,Rastriya Aam Jan Seva Party,138,0,138,0.08
U05,12,6,NAR SINGH,Sarvajan Hitay Party,603,1,604,0.36
U05,12,7,RAMESH KUMAR,Bhartiya Samajik Nyay Party,104,1,105,0.06
U05,12,8,RAJBALA SAINI,Loktanter Suraksha Party,1077,5,1082,0.65
U05,12,9,SURESH KUMAR,Peoples Party of India (Democratic),180,0,180,0.11
U05,12,10,SULESH KUMAR,Aapki Apni Party (Peoples),495,0,495,0.3
U05,12,11,ADITI,Independent,151,0,151,0.09
U05,12,12,NOTA,None of the Above,746,7,753,0.45
U05,13,1,NEEL DAMAN KHATRI,Bharatiya Janata Party,68244,589,68833,41.54
U05,13,2,MAHENDER CHAUDHARY,Bahujan Samaj Party,811,10,821,0.5
U05,13,3,SHARAD KUMAR,Aam Aadmi Party,86070,192,86262,52.06
U05,13,4,SIDDHARTH KUNDU,Indian National Congress,6240,30,6270,3.78
U05,13,5,CHAND RAM,Rastriya Aam Jan Seva Party,138,0,138,0.08
U05,13,6,NAR SINGH,Sarvajan Hitay Party,603,1,604,0.36
U05,13,7,RAMESH KUMAR,Bhartiya Samajik Nyay Party,104,1,105,0.06
U05,13,8,RAJBALA SAINI,Loktanter Suraksha Party,1077,5,1082,0.65
U05,13,9,SURESH KUMAR,Peoples Party of India (Democratic),180,0,180,0.11
U05,13,10,SULESH KUMAR,Aapki Apni Party (Peoples),495,0,495,0.3
U05,13,11,ADITI,Independent,151,0,151,0.09
U05,13,12,NOTA,None of the Above,746,7,753,0.45
U05,14,1,NEEL DAMAN KHATRI,Bharatiya Janata Party,68244,589,68833,41.54
U05,14,2,MAHENDER CHAUDHARY,Bahujan Samaj Party,811,10,821,0.5
U05,14,3,SHARAD KUMAR,Aam Aadmi Party,86070,192,86262,52.06
U05,14,4,SIDDHARTH KUNDU,Indian National Congress,6240,30,6270,3.78
U05,14,5,CHAND RAM,Rastriya Aam Jan Seva Party,138,0,138,0.08
U05,14,6,NAR SINGH,Sarvajan Hitay Party,603,1,604,0.36
U05,14,7,RAMESH KUMAR,Bhartiya Samajik Nyay Party,104,1,105,0.06
U05,14,8,RAJBALA SAINI,Loktanter Suraksha Party,1077,5,1082,0.65
U05,14,9,SURESH KUMAR,Peoples Party of India (Democratic),180,0,180,0.11
U05,14,10,SULESH KUMAR,Aapki Apni Party (Peoples),495,0,495,0.3
U05,14,11,ADITI,Independent,151,0,151,0.09
U05,14,12,NOTA,None of the Above,746,7,753,0.45
U05,15,1,NEEL DAMAN KHATRI,Bharatiya Janata Party,68244,589,68833,41.54
U05,15,2,MAHENDER CHAUDHARY,Bahujan Samaj Party,811,10,821,0.5
U05,15,3,SHARAD KUMAR,Aam Aadmi Party,86070,192,86262,52.06
U05,15,4,SIDDHARTH KUNDU,Indian National Congress,6240,30,6270,3.78
U05,15,5,CHAND RAM,Rastriya Aam Jan Seva Party,138,0,138,0.08
U05,15,6,NAR SINGH,Sarvajan Hitay Party,603,1,604,0.36
U05,15,7,RAMESH KUMAR,Bhartiya Samajik Nyay Party,104,1,105,0.06
U05,15,8,RAJBALA SAINI,Loktanter Suraksha Party,1077,5,1082,0.65
U05,15,9,SURESH KUMAR,Peoples Party of India (Democratic),180,0,180,0.11
U05,15,10,SULESH KUMAR,Aapki Apni Party (Peoples),495,0,495,0.3
U05,15,11,ADITI,Independent,151,0,151,0.09
U05,15,12,NOTA,None of the Above,746,7,753,0.45
U05,16,1,NEEL DAMAN KHATRI,Bharatiya Janata Party,68244,589,68833,41.54
U05,16,2,MAHENDER CHAUDHARY,Bahujan Samaj Party,811,10,821,0.5
U05,16,3,SHARAD KUMAR,Aam Aadmi Party,86070,192,86262,52.06
U05,16,4,SIDDHARTH KUNDU,Indian National Congress,6240,30,6270,3.78
U05,16,5,CHAND RAM,Rastriya Aam Jan Seva Party,138,0,138,0.08
U05,16,6,NAR SINGH,Sarvajan Hitay Party,603,1,604,0.36
U05,16,7,RAMESH KUMAR,Bhartiya Samajik Nyay Party,104,1,105,0.06
U05,16,8,RAJBALA SAINI,Loktanter Suraksha Party,1077,5,1082,0.65
U05,16,9,SURESH KUMAR,Peoples Party of India (Democratic),180,0,180,0.11
U05,16,10,SULESH KUMAR,Aapki Apni Party (Peoples),495,0,495,0.3
U05,16,11,ADITI,Independent,151,0,151,0.09
U05,16,12,NOTA,None of the Above,746,7,753,0.45
U05,17,1,NEEL DAMAN KHATRI,Bharatiya Janata Party,68244,589,68833,41.54
U05,17,2,MAHENDER CHAUDHARY,Bahujan Samaj Party,811,10,821,0.5
U05,17,3,SHARAD KUMAR,Aam Aadmi Party,86070,192,86262,52.06
U05,17,4,SIDDHARTH KUNDU,Indian National Congress,6240,30,6270,3.78
U05,17,5,CHAND RAM,Rastriya Aam Jan Seva Party,138,0,138,0.08
U05,17,6,NAR SINGH,Sarvajan Hitay Party,603,1,604,0.36
U05,17,7,RAMESH KUMAR,Bhartiya Samajik Nyay Party,104,1,105,0.06
U05,17,8,RAJBALA SAINI,Loktanter Suraksha Party,1077,5,1082,0.65
U05,17,9,SURESH KUMAR,Peoples Party of India (Democratic),180,0,180,0.11
U05,17,10,SULESH KUMAR,Aapki Apni Party (Peoples),495,0,495,0.3
U05,17,11,ADITI,Independent,151,0,151,0.09
U05,17,12,NOTA,None of the Above,746,7,753,0.45
U05,18,1,NEEL DAMAN KHATRI,Bharatiya Janata Party,68244,589,68833,41.54
U05,18,2,MAHENDER CHAUDHARY,Bahujan Samaj Party,811,10,821,0.5
U05,18,3,SHARAD KUMAR,Aam Aadmi Party,86070,192,86262,52.06
U05,18,4,SIDDHARTH KUNDU,Indian National Congress,6240,30,6270,3.78
U05,18,5,CHAND RAM,Rastriya Aam Jan Seva Party,138,0,138,0.08
U05,18,6,NAR SINGH,Sarvajan Hitay Party,603,1,604,0.36
U05,18,7,RAMESH KUMAR,Bhartiya Samajik Nyay Party,104,1,105,0.06
U05,18,8,RAJBALA SAINI,Loktanter Suraksha Party,1077,5,1082,0.65
U05,18,9,SURESH KUMAR,Peoples Party of India (Democratic),180,0,180,0.11
U05,18,10,SULESH KUMAR,Aapki Apni Party (Peoples),495,0,495,0.3
U05,18,11,ADITI,Independent,151,0,151,0.09
U05,18,12,NOTA,None of the Above,746,7,753,0.45
U05,19,1,NEEL DAMAN KHATRI,Bharatiya Janata Party,68244,589,68833,41.54
U05,19,2,MAHENDER CHAUDHARY,Bahujan Samaj Party,811,10,821,0.5
U05,19,3,SHARAD KUMAR,Aam Aadmi Party,86070,192,86262,52.06
U05,19,4,SIDDHARTH KUNDU,Indian National Congress,6240,30,6270,3.78
U05,19,5,CHAND RAM,Rastriya Aam Jan Seva Party,138,0,138,0.08
U05,19,6,NAR SINGH,Sarvajan Hitay Party,603,1,604,0.36
U05,19,7,RAMESH KUMAR,Bhartiya Samajik Nyay Party,104,1,105,0.06
U05,19,8,RAJBALA SAINI,Loktanter Suraksha Party,1077,5,1082,0.65
U05,19,9,SURESH KUMAR,Peoples Party of India (Democratic),180,0,180,0.11
U05,19,10,SULESH KUMAR,Aapki Apni Party (Peoples),495,0,495,0.3
U05,19,11,ADITI,Independent,151,0,151,0.09
U05,19,12,NOTA,None of the Above,746,7,753,0.45
U05,20,1,NEEL DAMAN KHATRI,Bharatiya Janata Party,68244,589,68833,41.54
U05,20,2,MAHENDER CHAUDHARY,Bahujan Samaj Party,811,10,821,0.5
U05,20,3,SHARAD KUMAR,Aam Aadmi Party,86070,192,86262,52.06
U05,20,4,SIDDHARTH KUNDU,Indian National Congress,6240,30,6270,3.78
U05,20,5,CHAND RAM,Rastriya Aam Jan Seva Party,138,0,138,0.08
U05,20,6,NAR SINGH,Sarvajan Hitay Party,603,1,604,0.36
U05,20,7,RAMESH KUMAR,Bhartiya Samajik Nyay Party,104,1,105,0.06
U05,20,8,RAJBALA SAINI,Loktanter Suraksha Party,1077,5,1082,0.65
U05,20,9,SURESH KUMAR,Peoples Party of India (Democratic),180,0,180,0.11
U05,20,10,SULESH KUMAR,Aapki Apni Party (Peoples),495,0,495,0.3
U05,20,11,ADITI,Independent,151,0,151,0.09
U05,20,12,NOTA,None of the Above,746,7,753,0.45
U05,21,1,NEEL DAMAN KHATRI,Bharatiya Janata Party,68244,589,68833,41.54
U05,21,2,MAHENDER CHAUDHARY,Bahujan Samaj Party,811,10,821,0.5
U05,21,3,SHARAD KUMAR,Aam Aadmi Party,86070,192,86262,52.06
U05,21,4,SIDDHARTH KUNDU,Indian National Congress,6240,30,6270,3.78
U05,21,5,CHAND RAM,Rastriya Aam Jan Seva Party,138,0,138,0.08
U05,21,6,NAR SINGH,Sarvajan Hitay Party,603,1,604,0.36
U05,21,7,RAMESH KUMAR,Bhartiya Samajik Nyay Party,104,1,105,0.06
U05,21,8,RAJBALA SAINI,Loktanter Suraksha Party,1077,5,1082,0.65
U05,21,9,SURESH KUMAR,Peoples Party of India (Democratic),180,0,180,0.11
U05,21,10,SULESH KUMAR,Aapki Apni Party (Peoples),495,0,495,0.3
U05,21,11,ADITI,Independent,151,0,151,0.09
U05,21,12,NOTA,None of the Above,746,7,753,0.45
U05,22,1,NEEL DAMAN KHATRI,Bharatiya Janata Party,68244,589,68833,41.54
U05,22,2,MAHENDER CHAUDHARY,Bahujan Samaj Party,811,10,821,0.5
U05,22,3,SHARAD KUMAR,Aam Aadmi Party,86070,192,86262,52.06
U05,22,4,SIDDHARTH KUNDU,Indian National Congress,6240,30,6270,3.78
U05,22,5,CHAND RAM,Rastriya Aam Jan Seva Party,138,0,138,0.08
U05,22,6,NAR SINGH,Sarvajan Hitay Party,603,1,604,0.36
U05,22,7,RAMESH KUMAR,Bhartiya Samajik Nyay Party,104,1,105,0.06
U05,22,8,RAJBALA SAINI,Loktanter Suraksha Party,1077,5,1082,0.65
U05,22,9,SURESH KUMAR,Peoples Party of India (Democratic),180,0,180,0.11
U05,22,10,SULESH KUMAR,Aapki Apni Party (Peoples),495,0,495,0.3
U05,22,11,ADITI,Independent,151,0,151,0.09
U05,22,12,NOTA,None of the Above,746,7,753,0.45
U05,23,1,NEEL DAMAN KHATRI,Bharatiya Janata Party,68244,589,68833,41.54
U05,23,2,MAHENDER CHAUDHARY,Bahujan Samaj Party,811,10,821,0.5
U05,23,3,SHARAD KUMAR,Aam Aadmi Party,86070,192,86262,52.06
U05,23,4,SIDDHARTH KUNDU,Indian National Congress,6240,30,6270,3.78
U05,23,5,CHAND RAM,Rastriya Aam Jan Seva Party,138,0,138,0.08
U05,23,6,NAR SINGH,Sarvajan Hitay Party,603,1,604,0.36
U05,23,7,RAMESH KUMAR,Bhartiya Samajik Nyay Party,104,1,105,0.06
U05,23,8,RAJBALA SAINI,Loktanter Suraksha Party,1077,5,1082,0.65
U05,23,9,SURESH KUMAR,Peoples Party of India (Democratic),180,0,180,0.11
U05,23,10,SULESH KUMAR,Aapki Apni Party (Peoples),495,0,495,0.3
U05,23,11,ADITI,Independent,151,0,151,0.09
U05,23,12,NOTA,None of the Above,746,7,753,0.45
U05,24,1,NEEL DAMAN KHATRI,Bharatiya Janata Party,68244,589,68833,41.54
U05,24,2,MAHENDER CHAUDHARY,Bahujan Samaj Party,811,10,821,0.5
U05,24,3,SHARAD KUMAR,Aam Aadmi Party,86070,192,86262,52.06
U05,24,4,SIDDHARTH KUNDU,Indian National Congress,6240,30,6270,3.78
U05,24,5,CHAND RAM,Rastriya Aam Jan Seva Party,138,0,138,0.08
U05,24,6,NAR SINGH,Sarvajan Hitay Party,603,1,604,0.36
U05,24,7,RAMESH KUMAR,Bhartiya Samajik Nyay Party,104,1,105,0.06
U05,24,8,RAJBALA SAINI,Loktanter Suraksha Party,1077,5,1082,0.65
U05,24,9,SURESH KUMAR,Peoples Party of India (Democratic),180,0,180,0.11
U05,24,10,SULESH KUMAR,Aapki Apni Party (Peoples),495,0,495,0.3
U05,24,11,ADITI,Independent,151,0,151,0.09
U05,24,12,NOTA,None of the Above,746,7,753,0.45
U05,25,1,NEEL DAMAN KHATRI,Bharatiya Janata Party,68244,589,68833,41.54
U05,25,2,MAHENDER CHAUDHARY,Bahujan Samaj Party,811,10,821,0.5
U05,25,3,SHARAD KUMAR,Aam Aadmi Party,86070,192,86262,52.06
U05,25,4,SIDDHARTH KUNDU,Indian National Congress,6240,30,6270,3.78
U05,25,5,CHAND RAM,Rastriya Aam Jan Seva Party,138,0,138,0.08
U05,25,6,NAR SINGH,Sarvajan Hitay Party,603,1,604,0.36
U05,25,7,RAMESH KUMAR,Bhartiya Samajik Nyay Party,104,1,105,0.06
U05,25,8,RAJBALA SAINI,Loktanter Suraksha Party,1077,5,1082,0.65
U05,25,9,SURESH KUMAR,Peoples Party of India (Democratic),180,0,180,0.11
U05,25,10,SULESH KUMAR,Aapki Apni Party (Peoples),495,0,495,0.3
U05,25,11,ADITI,Independent,151,0,151,0.09
U05,25,12,NOTA,None of the Above,746,7,753,0.45
U05,26,1,NEEL DAMAN KHATRI,Bharatiya Janata Party,68244,589,68833,41.54
U05,26,2,MAHENDER CHAUDHARY,Bahujan Samaj Party,811,10,821,0.5
U05,26,3,SHARAD KUMAR,Aam Aadmi Party,86070,192,86262,52.06
U05,26,4,SIDDHARTH KUNDU,Indian National Congress,6240,30,6270,3.78
U05,26,5,CHAND RAM,Rastriya Aam Jan Seva Party,138,0,138,0.08
U05,26,6,NAR SINGH,Sarvajan Hitay Party,603,1,604,0.36
U05,26,7,RAMESH KUMAR,Bhartiya Samajik Nyay Party,104,1,105,0.06
U05,26,8,RAJBALA SAINI,Loktanter Suraksha Party,1077,5,1082,0.65
U05,26,9,SURESH KUMAR,Peoples Party of India (Democratic),180,0,180,0.11
U05,26,10,SULESH KUMAR,Aapki Apni Party (Peoples),495,0,495,0.3
U05,26,11,ADITI,Independent,151,0,151,0.09
U05,26,12,NOTA,None of the Above,746,7,753,0.45
U05,27,1,NEEL DAMAN KHATRI,Bharatiya Janata Party,68244,589,68833,41.54
U05,27,2,MAHENDER CHAUDHARY,Bahujan Samaj Party,811,10,821,0.5
U05,27,3,SHARAD KUMAR,Aam Aadmi Party,86070,192,86262,52.06
U05,27,4,SIDDHARTH KUNDU,Indian National Congress,6240,30,6270,3.78
U05,27,5,CHAND RAM,Rastriya Aam Jan Seva Party,138,0,138,0.08
U05,27,6,NAR SINGH,Sarvajan Hitay Party,603,1,604,0.36
U05,27,7,RAMESH KUMAR,Bhartiya Samajik Nyay Party,104,1,105,0.06
U05,27,8,RAJBALA SAINI,Loktanter Suraksha Party,1077,5,1082,0.65
U05,27,9,SURESH KUMAR,Peoples Party of India (Democratic),180,0,180,0.11
U05,27,10,SULESH KUMAR,Aapki Apni Party (Peoples),495,0,495,0.3
U05,27,11,ADITI,Independent,151,0,151,0.09
U05,27,12,NOTA,None of the Above,746,7,753,0.45
U05,28,1,NEEL DAMAN KHATRI,Bharatiya Janata Party,68244,589,68833,41.54
U05,28,2,MAHENDER CHAUDHARY,Bahujan Samaj Party,811,10,821,0.5
U05,28,3,SHARAD KUMAR,Aam Aadmi Party,86070,192,86262,52.06
U05,28,4,SIDDHARTH KUNDU,Indian National Congress,6240,30,6270,3.78
U05,28,5,CHAND RAM,Rastriya Aam Jan Seva Party,138,0,138,0.08
U05,28,6,NAR SINGH,Sarvajan Hitay Party,603,1,604,0.36
U05,28,7,RAMESH KUMAR,Bhartiya Samajik Nyay Party,104,1,105,0.06
U05,28,8,RAJBALA SAINI,Loktanter Suraksha Party,1077,5,1082,0.65
U05,28,9,SURESH KUMAR,Peoples Party of India (Democratic),180,0,180,0.11
U05,28,10,SULESH KUMAR,Aapki Apni Party (Peoples),495,0,495,0.3
U05,28,11,ADITI,Independent,151,0,151,0.09
U05,28,12,NOTA,None of the Above,746,7,753,0.45
U05,29,1,NEEL DAMAN KHATRI,Bharatiya Janata Party,68244,589,68833,41.54
U05,29,2,MAHENDER CHAUDHARY,Bahujan Samaj Party,811,10,821,0.5
U05,29,3,SHARAD KUMAR,Aam Aadmi Party,86070,192,86262,52.06
U05,29,4,SIDDHARTH KUNDU,Indian National Congress,6240,30,6270,3.78
U05,29,5,CHAND RAM,Rastriya Aam Jan Seva Party,138,0,138,0.08
U05,29,6,NAR SINGH,Sarvajan Hitay Party,603,1,604,0.36
U05,29,7,RAMESH KUMAR,Bhartiya Samajik Nyay Party,104,1,105,0.06
U05,29,8,RAJBALA SAINI,Loktanter Suraksha Party,1077,5,1082,0.65
U05,29,9,SURESH KUMAR,Peoples Party of India (Democratic),180,0,180,0.11
U05,29,10,SULESH KUMAR,Aapki Apni Party (Peoples),495,0,495,0.3
U05,29,11,ADITI,Independent,151,0,151,0.09
U05,29,12,NOTA,None of the Above,746,7,753,0.45
U05,30,1,NEEL DAMAN KHATRI,Bharatiya Janata Party,68244,589,68833,41.54
U05,30,2,MAHENDER CHAUDHARY,Bahujan Samaj Party,811,10,821,0.5
U05,30,3,SHARAD KUMAR,Aam Aadmi Party,86070,192,86262,52.06
U05,30,4,SIDDHARTH KUNDU,Indian National Congress,6240,30,6270,3.78
U05,30,5,CHAND RAM,Rastriya Aam Jan Seva Party,138,0,138,0.08
U05,30,6,NAR SINGH,Sarvajan Hitay Party,603,1,604,0.36
U05,30,7,RAMESH KUMAR,Bhartiya Samajik Nyay Party,104,1,105,0.06
U05,30,8,RAJBALA SAINI,Loktanter Suraksha Party,1077,5,1082,0.65
U05,30,9,SURESH KUMAR,Peoples Party of India (Democratic),180,0,180,0.11
U05,30,10,SULESH KUMAR,Aapki Apni Party (Peoples),495,0,495,0.3
U05,30,11,ADITI,Independent,151,0,151,0.09
U05,30,12,NOTA,None of the Above,746,7,753,0.45
U05,31,1,NEEL DAMAN KHATRI,Bharatiya Janata Party,68244,589,68833,41.54
U05,31,2,MAHENDER CHAUDHARY,Bahujan Samaj Party,811,10,821,0.5
U05,31,3,SHARAD KUMAR,Aam Aadmi Party,86070,192,86262,52.06
U05,31,4,SIDDHARTH KUNDU,Indian National Congress,6240,30,6270,3.78
U05,31,5,CHAND RAM,Rastriya Aam Jan Seva Party,138,0,138,0.08
U05,31,6,NAR SINGH,Sarvajan Hitay Party,603,1,604,0.36
U05,31,7,RAMESH KUMAR,Bhartiya Samajik Nyay Party,104,1,105,0.06
U05,31,8,RAJBALA SAINI,Loktanter Suraksha Party,1077,5,1082,0.65
U05,31,9,SURESH KUMAR,Peoples Party of India (Democratic),180,0,180,0.11
U05,31,10,SULESH KUMAR,Aapki Apni Party (Peoples),495,0,495,0.3
U05,31,11,ADITI,Independent,151,0,151,0.09
U05,31,12,NOTA,None of the Above,746,7,753,0.45
U05,32,1,NEEL DAMAN KHATRI,Bharatiya Janata Party,68244,589,68833,41.54
U05,32,2,MAHENDER CHAUDHARY,Bahujan Samaj Party,811,10,821,0.5
U05,32,3,SHARAD KUMAR,Aam Aadmi Party,86070,192,86262,52.06
U05,32,4,SIDDHARTH KUNDU,Indian National Congress,6240,30,6270,3.78
U05,32,5,CHAND RAM,Rastriya Aam Jan Seva Party,138,0,138,0.08
U05,32,6,NAR SINGH,Sarvajan Hitay Party,603,1,604,0.36
U05,32,7,RAMESH KUMAR,Bhartiya Samajik Nyay Party,104,1,105,0.06
U05,32,8,RAJBALA SAINI,Loktanter Suraksha Party,1077,5,1082,0.65
U05,32,9,SURESH KUMAR,Peoples Party of India (Democratic),180,0,180,0.11
U05,32,10,SULESH KUMAR,Aapki Apni Party (Peoples),495,0,495,0.3
U05,32,11,ADITI,Independent,151,0,151,0.09
U05,32,12,NOTA,None of the Above,746,7,753,0.45
U05,33,1,NEEL DAMAN KHATRI,Bharatiya Janata Party,68244,589,68833,41.54
U05,33,2,MAHENDER CHAUDHARY,Bahujan Samaj Party,811,10,821,0.5
U05,33,3,SHARAD KUMAR,Aam Aadmi Party,86070,192,86262,52.06
U05,33,4,SIDDHARTH KUNDU,Indian National Congress,6240,30,6270,3.78
U05,33,5,CHAND RAM,Rastriya Aam Jan Seva Party,138,0,138,0.08
U05,33,6,NAR SINGH,Sarvajan Hitay Party,603,1,604,0.36
U05,33,7,RAMESH KUMAR,Bhartiya Samajik Nyay Party,104,1,105,0.06
U05,33,8,RAJBALA SAINI,Loktanter Suraksha Party,1077,5,1082,0.65
U05,33,9,SURESH KUMAR,Peoples Party of India (Democratic),180,0,180,0.11
U05,33,10,SULESH KUMAR,Aapki Apni Party (Peoples),495,0,495,0.3
U05,33,11,ADITI,Independent,151,0,151,0.09
U05,33,12,NOTA,None of the Above,746,7,753,0.45
U05,34,1,NEEL DAMAN KHATRI,Bharatiya Janata Party,68244,589,68833,41.54
U05,34,2,MAHENDER CHAUDHARY,Bahujan Samaj Party,811,10,821,0.5
U05,34,3,SHARAD KUMAR,Aam Aadmi Party,86070,192,86262,52.06
U05,34,4,SIDDHARTH KUNDU,Indian National Congress,6240,30,6270,3.78
U05,34,5,CHAND RAM,Rastriya Aam Jan Seva Party,138,0,138,0.08
U05,34,6,NAR SINGH,Sarvajan Hitay Party,603,1,604,0.36
U05,34,7,RAMESH KUMAR,Bhartiya Samajik Nyay Party,104,1,105,0.06
U05,34,8,RAJBALA SAINI,Loktanter Suraksha Party,1077,5,1082,0.65
U05,34,9,SURESH KUMAR,Peoples Party of India (Democratic),180,0,180,0.11
U05,34,10,SULESH KUMAR,Aapki Apni Party (Peoples),495,0,495,0.3
U05,34,11,ADITI,Independent,151,0,151,0.09
U05,34,12,NOTA,None of the Above,746,7,753,0.45
U05,35,1,NEEL DAMAN KHATRI,Bharatiya Janata Party,68244,589,68833,41.54
U05,35,2,MAHENDER CHAUDHARY,Bahujan Samaj Party,811,10,821,0.5
U05,35,3,SHARAD KUMAR,Aam Aadmi Party,86070,192,86262,52.06
U05,35,4,SIDDHARTH KUNDU,Indian National Congress,6240,30,6270,3.78
U05,35,5,CHAND RAM,Rastriya Aam Jan Seva Party,138,0,138,0.08
U05,35,6,NAR SINGH,Sarvajan Hitay Party,603,1,604,0.36
U05,35,7,RAMESH KUMAR,Bhartiya Samajik Nyay Party,104,1,105,0.06
U05,35,8,RAJBALA SAINI,Loktanter Suraksha Party,1077,5,1082,0.65
U05,35,9,SURESH KUMAR,Peoples Party of India (Democratic),180,0,180,0.11
U05,35,10,SULESH KUMAR,Aapki Apni Party (Peoples),495,0,495,0.3
U05,35,11,ADITI,Independent,151,0,151,0.09
U05,35,12,NOTA,None of the Above,746,7,753,0.45
U05,36,1,NEEL DAMAN KHATRI,Bharatiya Janata Party,68244,589,68833,41.54
U05,36,2,MAHENDER CHAUDHARY,Bahujan Samaj Party,811,10,821,0.5
U05,36,3,SHARAD KUMAR,Aam Aadmi Party,86070,192,86262,52.06
U05,36,4,SIDDHARTH KUNDU,Indian National Congress,6240,30,6270,3.78
U05,36,5,CHAND RAM,Rastriya Aam Jan Seva Party,138,0,138,0.08
U05,36,6,NAR SINGH,Sarvajan Hitay Party,603,1,604,0.36
U05,36,7,RAMESH KUMAR,Bhartiya Samajik Nyay Party,104,1,105,0.06
U05,36,8,RAJBALA SAINI,Loktanter Suraksha Party,1077,5,1082,0.65
U05,36,9,SURESH KUMAR,Peoples Party of India (Democratic),180,0,180,0.11
U05,36,10,SULESH KUMAR,Aapki Apni Party (Peoples),495,0,495,0.3
U05,36,11,ADITI,Independent,151,0,151,0.09
U05,36,12,NOTA,None of the Above,746,7,753,0.45
U05,37,1,NEEL DAMAN KHATRI,Bharatiya Janata Party,68244,589,68833,41.54
U05,37,2,MAHENDER CHAUDHARY,Bahujan Samaj Party,811,10,821,0.5
U05,37,3,SHARAD KUMAR,Aam Aadmi Party,86070,192,86262,52.06
U05,37,4,SIDDHARTH KUNDU,Indian National Congress,6240,30,6270,3.78
U05,37,5,CHAND RAM,Rastriya Aam Jan Seva Party,138,0,138,0.08
U05,37,6,NAR SINGH,Sarvajan Hitay Party,603,1,604,0.36
U05,37,7,RAMESH KUMAR,Bhartiya Samajik Nyay Party,104,1,105,0.06
U05,37,8,RAJBALA SAINI,Loktanter Suraksha Party,1077,5,1082,0.65
U05,37,9,SURESH KUMAR,Peoples Party of India (Democratic),180,0,180,0.11
U05,37,10,SULESH KUMAR,Aapki Apni Party (Peoples),495,0,495,0.3
U05,37,11,ADITI,Independent,151,0,151,0.09
U05,37,12,NOTA,None of the Above,746,7,753,0.45
U05,38,1,NEEL DAMAN KHATRI,Bharatiya Janata Party,68244,589,68833,41.54
U05,38,2,MAHENDER CHAUDHARY,Bahujan Samaj Party,811,10,821,0.5
U05,38,3,SHARAD KUMAR,Aam Aadmi Party,86070,192,86262,52.06
U05,38,4,SIDDHARTH KUNDU,Indian National Congress,6240,30,6270,3.78
U05,38,5,CHAND RAM,Rastriya Aam Jan Seva Party,138,0,138,0.08
U05,38,6,NAR SINGH,Sarvajan Hitay Party,603,1,604,0.36
U05,38,7,RAMESH KUMAR,Bhartiya Samajik Nyay Party,104,1,105,0.06
U05,38,8,RAJBALA SAINI,Loktanter Suraksha Party,1077,5,1082,0.65
U05,38,9,SURESH KUMAR,Peoples Party of India (Democratic),180,0,180,0.11
U05,38,10,SULESH KUMAR,Aapki Apni Party (Peoples),495,0,495,0.3
U05,38,11,ADITI,Independent,151,0,151,0.09
U05,38,12,NOTA,None of the Above,746,7,753,0.45
U05,39,1,NEEL DAMAN KHATRI,Bharatiya Janata Party,68244,589,68833,41.54
U05,39,2,MAHENDER CHAUDHARY,Bahujan Samaj Party,811,10,821,0.5
U05,39,3,SHARAD KUMAR,Aam Aadmi Party,86070,192,86262,52.06
U05,39,4,SIDDHARTH KUNDU,Indian National Congress,6240,30,6270,3.78
U05,39,5,CHAND RAM,Rastriya Aam Jan Seva Party,138,0,138,0.08
U05,39,6,NAR SINGH,Sarvajan Hitay Party,603,1,604,0.36
U05,39,7,RAMESH KUMAR,Bhartiya Samajik Nyay Party,104,1,105,0.06
U05,39,8,RAJBALA SAINI,Loktanter Suraksha Party,1077,5,1082,0.65
U05,39,9,SURESH KUMAR,Peoples Party of India (Democratic),180,0,180,0.11
U05,39,10,SULESH KUMAR,Aapki Apni Party (Peoples),495,0,495,0.3
U05,39,11,ADITI,Independent,151,0,151,0.09
U05,39,12,NOTA,None of the Above,746,7,753,0.45
U05,40,1,NEEL DAMAN KHATRI,Bharatiya Janata Party,68244,589,68833,41.54
U05,40,2,MAHENDER CHAUDHARY,Bahujan Samaj Party,811,10,821,0.5
U05,40,3,SHARAD KUMAR,Aam Aadmi Party,86070,192,86262,52.06
U05,40,4,SIDDHARTH KUNDU,Indian National Congress,6240,30,6270,3.78
U05,40,5,CHAND RAM,Rastriya Aam Jan Seva Party,138,0,138,0.08
U05,40,6,NAR SINGH,Sarvajan Hitay Party,603,1,604,0.36
U05,40,7,RAMESH KUMAR,Bhartiya Samajik Nyay Party,104,1,105,0.06
U05,40,8,RAJBALA SAINI,Loktanter Suraksha Party,1077,5,1082,0.65
U05,40,9,SURESH KUMAR,Peoples Party of India (Democratic),180,0,180,0.11
U05,40,10,SULESH KUMAR,Aapki Apni Party (Peoples),495,0,495,0.3
U05,40,11,ADITI,Independent,151,0,151,0.09
U05,40,12,NOTA,None of the Above,746,7,753,0.45
U05,41,1,NEEL DAMAN KHATRI,Bharatiya Janata Party,68244,589,68833,41.54
U05,41,2,MAHENDER CHAUDHARY,Bahujan Samaj Party,811,10,821,0.5
U05,41,3,SHARAD KUMAR,Aam Aadmi Party,86070,192,86262,52.06
U05,41,4,SIDDHARTH KUNDU,Indian National Congress,6240,30,6270,3.78
U05,41,5,CHAND RAM,Rastriya Aam Jan Seva Party,138,0,138,0.08
U05,41,6,NAR SINGH,Sarvajan Hitay Party,603,1,604,0.36
U05,41,7,RAMESH KUMAR,Bhartiya Samajik Nyay Party,104,1,105,0.06
U05,41,8,RAJBALA SAINI,Loktanter Suraksha Party,1077,5,1082,0.65
U05,41,9,SURESH KUMAR,Peoples Party of India (Democratic),180,0,180,0.11
U05,41,10,SULESH KUMAR,Aapki Apni Party (Peoples),495,0,495,0.3
U05,41,11,ADITI,Independent,151,0,151,0.09
U05,41,12,NOTA,None of the Above,746,7,753,0.45
U05,42,1,NEEL DAMAN KHATRI,Bharatiya Janata Party,68244,589,68833,41.54
U05,42,2,MAHENDER CHAUDHARY,Bahujan Samaj Party,811,10,821,0.5
U05,42,3,SHARAD KUMAR,Aam Aadmi Party,86070,192,86262,52.06
U05,42,4,SIDDHARTH KUNDU,Indian National Congress,6240,30,6270,3.78
U05,42,5,CHAND RAM,Rastriya Aam Jan Seva Party,138,0,138,0.08
U05,42,6,NAR SINGH,Sarvajan Hitay Party,603,1,604,0.36
U05,42,7,RAMESH KUMAR,Bhartiya Samajik Nyay Party,104,1,105,0.06
U05,42,8,RAJBALA SAINI,Loktanter Suraksha Party,1077,5,1082,0.65
U05,42,9,SURESH KUMAR,Peoples Party of India (Democratic),180,0,180,0.11
U05,42,10,SULESH KUMAR,Aapki Apni Party (Peoples),495,0,495,0.3
U05,42,11,ADITI,Independent,151,0,151,0.09
U05,42,12,NOTA,None of the Above,746,7,753,0.45
U05,43,1,NEEL DAMAN KHATRI,Bharatiya Janata Party,68244,589,68833,41.54
U05,43,2,MAHENDER CHAUDHARY,Bahujan Samaj Party,811,10,821,0.5
U05,43,3,SHARAD KUMAR,Aam Aadmi Party,86070,192,86262,52.06
U05,43,4,SIDDHARTH KUNDU,Indian National Congress,6240,30,6270,3.78
U05,43,5,CHAND RAM,Rastriya Aam Jan Seva Party,138,0,138,0.08
U05,43,6,NAR SINGH,Sarvajan Hitay Party,603,1,604,0.36
U05,43,7,RAMESH KUMAR,Bhartiya Samajik Nyay Party,104,1,105,0.06
U05,43,8,RAJBALA SAINI,Loktanter Suraksha Party,1077,5,1082,0.65
U05,43,9,SURESH KUMAR,Peoples Party of India (Democratic),180,0,180,0.11
U05,43,10,SULESH KUMAR,Aapki Apni Party (Peoples),495,0,495,0.3
U05,43,11,ADITI,Independent,151,0,151,0.09
U05,43,12,NOTA,None of the Above,746,7,753,0.45
U05,44,1,NEEL DAMAN KHATRI,Bharatiya Janata Party,68244,589,68833,41.54
U05,44,2,MAHENDER CHAUDHARY,Bahujan Samaj Party,811,10,821,0.5
U05,44,3,SHARAD KUMAR,Aam Aadmi Party,86070,192,86262,52.06
U05,44,4,SIDDHARTH KUNDU,Indian National Congress,6240,30,6270,3.78
U05,44,5,CHAND RAM,Rastriya Aam Jan Seva Party,138,0,138,0.08
U05,44,6,NAR SINGH,Sarvajan Hitay Party,603,1,604,0.36
U05,44,7,RAMESH KUMAR,Bhartiya Samajik Nyay Party,104,1,105,0.06
U05,44,8,RAJBALA SAINI,Loktanter Suraksha Party,1077,5,1082,0.65
U05,44,9,SURESH KUMAR,Peoples Party of India (Democratic),180,0,180,0.11
U05,44,10,SULESH KUMAR,Aapki Apni Party (Peoples),495,0,495,0.3
U05,44,11,ADITI,Independent,151,0,151,0.09
U05,44,12,NOTA,None of the Above,746,7,753,0.45
U05,45,1,NEEL DAMAN KHATRI,Bharatiya Janata Party,68244,589,68833,41.54
U05,45,2,MAHENDER CHAUDHARY,Bahujan Samaj Party,811,10,821,0.5
U05,45,3,SHARAD KUMAR,Aam Aadmi Party,86070,192,86262,52.06
U05,45,4,SIDDHARTH KUNDU,Indian National Congress,6240,30,6270,3.78
U05,45,5,CHAND RAM,Rastriya Aam Jan Seva Party,138,0,138,0.08
U05,45,6,NAR SINGH,Sarvajan Hitay Party,603,1,604,0.36
U05,45,7,RAMESH KUMAR,Bhartiya Samajik Nyay Party,104,1,105,0.06
U05,45,8,RAJBALA SAINI,Loktanter Suraksha Party,1077,5,1082,0.65
U05,45,9,SURESH KUMAR,Peoples Party of India (Democratic),180,0,180,0.11
U05,45,10,SULESH KUMAR,Aapki Apni Party (Peoples),495,0,495,0.3
U05,45,11,ADITI,Independent,151,0,151,0.09
U05,45,12,NOTA,None of the Above,746,7,753,0.45
U05,46,1,NEEL DAMAN KHATRI,Bharatiya Janata Party,68244,589,68833,41.54
U05,46,2,MAHENDER CHAUDHARY,Bahujan Samaj Party,811,10,821,0.5
U05,46,3,SHARAD KUMAR,Aam Aadmi Party,86070,192,86262,52.06
U05,46,4,SIDDHARTH KUNDU,Indian National Congress,6240,30,6270,3.78
U05,46,5,CHAND RAM,Rastriya Aam Jan Seva Party,138,0,138,0.08
U05,46,6,NAR SINGH,Sarvajan Hitay Party,603,1,604,0.36
U05,46,7,RAMESH KUMAR,Bhartiya Samajik Nyay Party,104,1,105,0.06
U05,46,8,RAJBALA SAINI,Loktanter Suraksha Party,1077,5,1082,0.65
U05,46,9,SURESH KUMAR,Peoples Party of India (Democratic),180,0,180,0.11
U05,46,10,SULESH KUMAR,Aapki Apni Party (Peoples),495,0,495,0.3
U05,46,11,ADITI,Independent,151,0,151,0.09
U05,46,12,NOTA,None of the Above,746,7,753,0.45
U05,47,1,NEEL DAMAN KHATRI,Bharatiya Janata Party,68244,589,68833,41.54
U05,47,2,MAHENDER CHAUDHARY,Bahujan Samaj Party,811,10,821,0.5
U05,47,3,SHARAD KUMAR,Aam Aadmi Party,86070,192,86262,52.06
U05,47,4,SIDDHARTH KUNDU,Indian National Congress,6240,30,6270,3.78
U05,47,5,CHAND RAM,Rastriya Aam Jan Seva Party,138,0,138,0.08
U05,47,6,NAR SINGH,Sarvajan Hitay Party,603,1,604,0.36
U05,47,7,RAMESH KUMAR,Bhartiya Samajik Nyay Party,104,1,105,0.06
U05,47,8,RAJBALA SAINI,Loktanter Suraksha Party,1077,5,1082,0.65
U05,47,9,SURESH KUMAR,Peoples Party of India (Democratic),180,0,180,0.11
U05,47,10,SULESH KUMAR,Aapki Apni Party (Peoples),495,0,495,0.3
U05,47,11,ADITI,Independent,151,0,151,0.09
U05,47,12,NOTA,None of the Above,746,7,753,0.45
U05,48,1,NEEL DAMAN KHATRI,Bharatiya Janata Party,68244,589,68833,41.54
U05,48,2,MAHENDER CHAUDHARY,Bahujan Samaj Party,811,10,821,0.5
U05,48,3,SHARAD KUMAR,Aam Aadmi Party,86070,192,86262,52.06
U05,48,4,SIDDHARTH KUNDU,Indian National Congress,6240,30,6270,3.78
U05,48,5,CHAND RAM,Rastriya Aam Jan Seva Party,138,0,138,0.08
U05,48,6,NAR SINGH,Sarvajan Hitay Party,603,1,604,0.36
U05,48,7,RAMESH KUMAR,Bhartiya Samajik Nyay Party,104,1,105,0.06
U05,48,8,RAJBALA SAINI,Loktanter Suraksha Party,1077,5,1082,0.65
U05,48,9,SURESH KUMAR,Peoples Party of India (Democratic),180,0,180,0.11
U05,48,10,SULESH KUMAR,Aapki Apni Party (Peoples),495,0,495,0.3
U05,48,11,ADITI,Independent,151,0,151,0.09
U05,48,12,NOTA,None of the Above,746,7,753,0.45
U05,49,1,NEEL DAMAN KHATRI,Bharatiya Janata Party,68244,589,68833,41.54
U05,49,2,MAHENDER CHAUDHARY,Bahujan Samaj Party,811,10,821,0.5
U05,49,3,SHARAD KUMAR,Aam Aadmi Party,86070,192,86262,52.06
U05,49,4,SIDDHARTH KUNDU,Indian National Congress,6240,30,6270,3.78
U05,49,5,CHAND RAM,Rastriya Aam Jan Seva Party,138,0,138,0.08
U05,49,6,NAR SINGH,Sarvajan Hitay Party,603,1,604,0.36
U05,49,7,RAMESH KUMAR,Bhartiya Samajik Nyay Party,104,1,105,0.06
U05,49,8,RAJBALA SAINI,Loktanter Suraksha Party,1077,5,1082,0.65
U05,49,9,SURESH KUMAR,Peoples Party of India (Democratic),180,0,180,0.11
U05,49,10,SULESH KUMAR,Aapki Apni Party (Peoples),495,0,495,0.3
U05,49,11,ADITI,Independent,151,0,151,0.09
U05,49,12,NOTA,None of the Above,746,7,753,0.45
U05,50,1,NEEL DAMAN KHATRI,Bharatiya Janata Party,68244,589,68833,41.54
U05,50,2,MAHENDER CHAUDHARY,Bahujan Samaj Party,811,10,821,0.5
U05,50,3,SHARAD KUMAR,Aam Aadmi Party,86070,192,86262,52.06
U05,50,4,SIDDHARTH KUNDU,Indian National Congress,6240,30,6270,3.78
U05,50,5,CHAND RAM,Rastriya Aam Jan Seva Party,138,0,138,0.08
U05,50,6,NAR SINGH,Sarvajan Hitay Party,603,1,604,0.36
U05,50,7,RAMESH KUMAR,Bhartiya Samajik Nyay Party,104,1,105,0.06
U05,50,8,RAJBALA SAINI,Loktanter Suraksha Party,1077,5,1082,0.65
U05,50,9,SURESH KUMAR,Peoples Party of India (Democratic),180,0,180,0.11
U05,50,10,SULESH KUMAR,Aapki Apni Party (Peoples),495,0,495,0.3
U05,50,11,ADITI,Independent,151,0,151,0.09
U05,50,12,NOTA,None of the Above,746,7,753,0.45
U05,51,1,NEEL DAMAN KHATRI,Bharatiya Janata Party,68244,589,68833,41.54
U05,51,2,MAHENDER CHAUDHARY,Bahujan Samaj Party,811,10,821,0.5
U05,51,3,SHARAD KUMAR,Aam Aadmi Party,86070,192,86262,52.06
U05,51,4,SIDDHARTH KUNDU,Indian National Congress,6240,30,6270,3.78
U05,51,5,CHAND RAM,Rastriya Aam Jan Seva Party,138,0,138,0.08
U05,51,6,NAR SINGH,Sarvajan Hitay Party,603,1,604,0.36
U05,51,7,RAMESH KUMAR,Bhartiya Samajik Nyay Party,104,1,105,0.06
U05,51,8,RAJBALA SAINI,Loktanter Suraksha Party,1077,5,1082,0.65
U05,51,9,SURESH KUMAR,Peoples Party of India (Democratic),180,0,180,0.11
U05,51,10,SULESH KUMAR,Aapki Apni Party (Peoples),495,0,495,0.3
U05,51,11,ADITI,Independent,151,0,151,0.09
U05,51,12,NOTA,None of the Above,746,7,753,0.45
U05,52,1,NEEL DAMAN KHATRI,Bharatiya Janata Party,68244,589,68833,41.54
U05,52,2,MAHENDER CHAUDHARY,Bahujan Samaj Party,811,10,821,0.5
U05,52,3,SHARAD KUMAR,Aam Aadmi Party,86070,192,86262,52.06
U05,52,4,SIDDHARTH KUNDU,Indian National Congress,6240,30,6270,3.78
U05,52,5,CHAND RAM,Rastriya Aam Jan Seva Party,138,0,138,0.08
U05,52,6,NAR SINGH,Sarvajan Hitay Party,603,1,604,0.36
U05,52,7,RAMESH KUMAR,Bhartiya Samajik Nyay Party,104,1,105,0.06
U05,52,8,RAJBALA SAINI,Loktanter Suraksha Party,1077,5,1082,0.65
U05,52,9,SURESH KUMAR,Peoples Party of India (Democratic),180,0,180,0.11
U05,52,10,SULESH KUMAR,Aapki Apni Party (Peoples),495,0,495,0.3
U05,52,11,ADITI,Independent,151,0,151,0.09
U05,52,12,NOTA,None of the Above,746,7,753,0.45
U05,53,1,NEEL DAMAN KHATRI,Bharatiya Janata Party,68244,589,68833,41.54
U05,53,2,MAHENDER CHAUDHARY,Bahujan Samaj Party,811,10,821,0.5
U05,53,3,SHARAD KUMAR,Aam Aadmi Party,86070,192,86262,52.06
U05,53,4,SIDDHARTH KUNDU,Indian National Congress,6240,30,6270,3.78
U05,53,5,CHAND RAM,Rastriya Aam Jan Seva Party,138,0,138,0.08
U05,53,6,NAR SINGH,Sarvajan Hitay Party,603,1,604,0.36
U05,53,7,RAMESH KUMAR,Bhartiya Samajik Nyay Party,104,1,105,0.06
U05,53,8,RAJBALA SAINI,Loktanter Suraksha Party,1077,5,1082,0.65
U05,53,9,SURESH KUMAR,Peoples Party of India (Democratic),180,0,180,0.11
U05,53,10,SULESH KUMAR,Aapki Apni Party (Peoples),495,0,495,0.3
U05,53,11,ADITI,Independent,151,0,151,0.09
U05,53,12,NOTA,None of the Above,746,7,753,0.45
U05,54,1,NEEL DAMAN KHATRI,Bharatiya Janata Party,68244,589,68833,41.54
U05,54,2,MAHENDER CHAUDHARY,Bahujan Samaj Party,811,10,821,0.5
U05,54,3,SHARAD KUMAR,Aam Aadmi Party,86070,192,86262,52.06
U05,54,4,SIDDHARTH KUNDU,Indian National Congress,6240,30,6270,3.78
U05,54,5,CHAND RAM,Rastriya Aam Jan Seva Party,138,0,138,0.08
U05,54,6,NAR SINGH,Sarvajan Hitay Party,603,1,604,0.36
U05,54,7,RAMESH KUMAR,Bhartiya Samajik Nyay Party,104,1,105,0.06
U05,54,8,RAJBALA SAINI,Loktanter Suraksha Party,1077,5,1082,0.65
U05,54,9,SURESH KUMAR,Peoples Party of India (Democratic),180,0,180,0.11
U05,54,10,SULESH KUMAR,Aapki Apni Party (Peoples),495,0,495,0.3
U05,54,11,ADITI,Independent,151,0,151,0.09
U05,54,12,NOTA,None of the Above,746,7,753,0.45
U05,55,1,NEEL DAMAN KHATRI,Bharatiya Janata Party,68244,589,68833,41.54
U05,55,2,MAHENDER CHAUDHARY,Bahujan Samaj Party,811,10,821,0.5
U05,55,3,SHARAD KUMAR,Aam Aadmi Party,86070,192,86262,52.06
U05,55,4,SIDDHARTH KUNDU,Indian National Congress,6240,30,6270,3.78
U05,55,5,CHAND RAM,Rastriya Aam Jan Seva Party,138,0,138,0.08
U05,55,6,NAR SINGH,Sarvajan Hitay Party,603,1,604,0.36
U05,55,7,RAMESH KUMAR,Bhartiya Samajik Nyay Party,104,1,105,0.06
U05,55,8,RAJBALA SAINI,Loktanter Suraksha Party,1077,5,1082,0.65
U05,55,9,SURESH KUMAR,Peoples Party of India (Democratic),180,0,180,0.11
U05,55,10,SULESH KUMAR,Aapki Apni Party (Peoples),495,0,495,0.3
U05,55,11,ADITI,Independent,151,0,151,0.09
U05,55,12,NOTA,None of the Above,746,7,753,0.45
U05,56,1,NEEL DAMAN KHATRI,Bharatiya Janata Party,68244,589,68833,41.54
U05,56,2,MAHENDER CHAUDHARY,Bahujan Samaj Party,811,10,821,0.5
U05,56,3,SHARAD KUMAR,Aam Aadmi Party,86070,192,86262,52.06
U05,56,4,SIDDHARTH KUNDU,Indian National Congress,6240,30,6270,3.78
U05,56,5,CHAND RAM,Rastriya Aam Jan Seva Party,138,0,138,0.08
U05,56,6,NAR SINGH,Sarvajan Hitay Party,603,1,604,0.36
U05,56,7,RAMESH KUMAR,Bhartiya Samajik Nyay Party,104,1,105,0.06
U05,56,8,RAJBALA SAINI,Loktanter Suraksha Party,1077,5,1082,0.65
U05,56,9,SURESH KUMAR,Peoples Party of India (Democratic),180,0,180,0.11
U05,56,10,SULESH KUMAR,Aapki Apni Party (Peoples),495,0,495,0.3
U05,56,11,ADITI,Independent,151,0,151,0.09
U05,56,12,NOTA,None of the Above,746,7,753,0.45
U05,57,1,NEEL DAMAN KHATRI,Bharatiya Janata Party,68244,589,68833,41.54
U05,57,2,MAHENDER CHAUDHARY,Bahujan Samaj Party,811,10,821,0.5
U05,57,3,SHARAD KUMAR,Aam Aadmi Party,86070,192,86262,52.06
U05,57,4,SIDDHARTH KUNDU,Indian National Congress,6240,30,6270,3.78
U05,57,5,CHAND RAM,Rastriya Aam Jan Seva Party,138,0,138,0.08
U05,57,6,NAR SINGH,Sarvajan Hitay Party,603,1,604,0.36
U05,57,7,RAMESH KUMAR,Bhartiya Samajik Nyay Party,104,1,105,0.06
U05,57,8,RAJBALA SAINI,Loktanter Suraksha Party,1077,5,1082,0.65
U05,57,9,SURESH KUMAR,Peoples Party of India (Democratic),180,0,180,0.11
U05,57,10,SULESH KUMAR,Aapki Apni Party (Peoples),495,0,495,0.3
U05,57,11,ADITI,Independent,151,0,151,0.09
U05,57,12,NOTA,None of the Above,746,7,753,0.45
U05,58,1,NEEL DAMAN KHATRI,Bharatiya Janata Party,68244,589,68833,41.54
U05,58,2,MAHENDER CHAUDHARY,Bahujan Samaj Party,811,10,821,0.5
U05,58,3,SHARAD KUMAR,Aam Aadmi Party,86070,192,86262,52.06
U05,58,4,SIDDHARTH KUNDU,Indian National Congress,6240,30,6270,3.78
U05,58,5,CHAND RAM,Rastriya Aam Jan Seva Party,138,0,138,0.08
U05,58,6,NAR SINGH,Sarvajan Hitay Party,603,1,604,0.36
U05,58,7,RAMESH KUMAR,Bhartiya Samajik Nyay Party,104,1,105,0.06
U05,58,8,RAJBALA SAINI,Loktanter Suraksha Party,1077,5,1082,0.65
U05,58,9,SURESH KUMAR,Peoples Party of India (Democratic),180,0,180,0.11
U05,58,10,SULESH KUMAR,Aapki Apni Party (Peoples),495,0,495,0.3
U05,58,11,ADITI,Independent,151,0,151,0.09
U05,58,12,NOTA,None of the Above,746,7,753,0.45
U05,59,1,NEEL DAMAN KHATRI,Bharatiya Janata Party,68244,589,68833,41.54
U05,59,2,MAHENDER CHAUDHARY,Bahujan Samaj Party,811,10,821,0.5
U05,59,3,SHARAD KUMAR,Aam Aadmi Party,86070,192,86262,52.06
U05,59,4,SIDDHARTH KUNDU,Indian National Congress,6240,30,6270,3.78
U05,59,5,CHAND RAM,Rastriya Aam Jan Seva Party,138,0,138,0.08
U05,59,6,NAR SINGH,Sarvajan Hitay Party,603,1,604,0.36
U05,59,7,RAMESH KUMAR,Bhartiya Samajik Nyay Party,104,1,105,0.06
U05,59,8,RAJBALA SAINI,Loktanter Suraksha Party,1077,5,1082,0.65
U05,59,9,SURESH KUMAR,Peoples Party of India (Democratic),180,0,180,0.11
U05,59,10,SULESH KUMAR,Aapki Apni Party (Peoples),495,0,495,0.3
U05,59,11,ADITI,Independent,151,0,151,0.09
U05,59,12,NOTA,None of the Above,746,7,753,0.45
U05,60,1,NEEL DAMAN KHATRI,Bharatiya Janata Party,68244,589,68833,41.54
U05,60,2,MAHENDER CHAUDHARY,Bahujan Samaj Party,811,10,821,0.5
U05,60,3,SHARAD KUMAR,Aam Aadmi Party,86070,192,86262,52.06
U05,60,4,SIDDHARTH KUNDU,Indian National Congress,6240,30,6270,3.78
U05,60,5,CHAND RAM,Rastriya Aam Jan Seva Party,138,0,138,0.08
U05,60,6,NAR SINGH,Sarvajan Hitay Party,603,1,604,0.36
U05,60,7,RAMESH KUMAR,Bhartiya Samajik Nyay Party,104,1,105,0.06
U05,60,8,RAJBALA SAINI,Loktanter Suraksha Party,1077,5,1082,0.65
U05,60,9,SURESH KUMAR,Peoples Party of India (Democratic),180,0,180,0.11
U05,60,10,SULESH KUMAR,Aapki Apni Party (Peoples),495,0,495,0.3
U05,60,11,ADITI,Independent,151,0,151,0.09
U05,60,12,NOTA,None of the Above,746,7,753,0.45
U05,61,1,NEEL DAMAN KHATRI,Bharatiya Janata Party,68244,589,68833,41.54
U05,61,2,MAHENDER CHAUDHARY,Bahujan Samaj Party,811,10,821,0.5
U05,61,3,SHARAD KUMAR,Aam Aadmi Party,86070,192,86262,52.06
U05,61,4,SIDDHARTH KUNDU,Indian National Congress,6240,30,6270,3.78
U05,61,5,CHAND RAM,Rastriya Aam Jan Seva Party,138,0,138,0.08
U05,61,6,NAR SINGH,Sarvajan Hitay Party,603,1,604,0.36
U05,61,7,RAMESH KUMAR,Bhartiya Samajik Nyay Party,104,1,105,0.06
U05,61,8,RAJBALA SAINI,Loktanter Suraksha Party,1077,5,1082,0.65
U05,61,9,SURESH KUMAR,Peoples Party of India (Democratic),180,0,180,0.11
U05,61,10,SULESH KUMAR,Aapki Apni Party (Peoples),495,0,495,0.3
U05,61,11,ADITI,Independent,151,0,151,0.09
U05,61,12,NOTA,None of the Above,746,7,753,0.45
U05,62,1,NEEL DAMAN KHATRI,Bharatiya Janata Party,68244,589,68833,41.54
U05,62,2,MAHENDER CHAUDHARY,Bahujan Samaj Party,811,10,821,0.5
U05,62,3,SHARAD KUMAR,Aam Aadmi Party,86070,192,86262,52.06
U05,62,4,SIDDHARTH KUNDU,Indian National Congress,6240,30,6270,3.78
U05,62,5,CHAND RAM,Rastriya Aam Jan Seva Party,138,0,138,0.08
U05,62,6,NAR SINGH,Sarvajan Hitay Party,603,1,604,0.36
U05,62,7,RAMESH KUMAR,Bhartiya Samajik Nyay Party,104,1,105,0.06
U05,62,8,RAJBALA SAINI,Loktanter Suraksha Party,1077,5,1082,0.65
U05,62,9,SURESH KUMAR,Peoples Party of India (Democratic),180,0,180,0.11
U05,62,10,SULESH KUMAR,Aapki Apni Party (Peoples),495,0,495,0.3
U05,62,11,ADITI,Independent,151,0,151,0.09
U05,62,12,NOTA,None of the Above,746,7,753,0.45
U05,63,1,NEEL DAMAN KHATRI,Bharatiya Janata Party,68244,589,68833,41.54
U05,63,2,MAHENDER CHAUDHARY,Bahujan Samaj Party,811,10,821,0.5
U05,63,3,SHARAD KUMAR,Aam Aadmi Party,86070,192,86262,52.06
U05,63,4,SIDDHARTH KUNDU,Indian National Congress,6240,30,6270,3.78
U05,63,5,CHAND RAM,Rastriya Aam Jan Seva Party,138,0,138,0.08
U05,63,6,NAR SINGH,Sarvajan Hitay Party,603,1,604,0.36
U05,63,7,RAMESH KUMAR,Bhartiya Samajik Nyay Party,104,1,105,0.06
U05,63,8,RAJBALA SAINI,Loktanter Suraksha Party,1077,5,1082,0.65
U05,63,9,SURESH KUMAR,Peoples Party of India (Democratic),180,0,180,0.11
U05,63,10,SULESH KUMAR,Aapki Apni Party (Peoples),495,0,495,0.3
U05,63,11,ADITI,Independent,151,0,151,0.09
U05,63,12,NOTA,None of the Above,746,7,753,0.45
U05,64,1,NEEL DAMAN KHATRI,Bharatiya Janata Party,68244,589,68833,41.54
U05,64,2,MAHENDER CHAUDHARY,Bahujan Samaj Party,811,10,821,0.5
U05,64,3,SHARAD KUMAR,Aam Aadmi Party,86070,192,86262,52.06
U05,64,4,SIDDHARTH KUNDU,Indian National Congress,6240,30,6270,3.78
U05,64,5,CHAND RAM,Rastriya Aam Jan Seva Party,138,0,138,0.08
U05,64,6,NAR SINGH,Sarvajan Hitay Party,603,1,604,0.36
U05,64,7,RAMESH KUMAR,Bhartiya Samajik Nyay Party,104,1,105,0.06
U05,64,8,RAJBALA SAINI,Loktanter Suraksha Party,1077,5,1082,0.65
U05,64,9,SURESH KUMAR,Peoples Party of India (Democratic),180,0,180,0.11
U05,64,10,SULESH KUMAR,Aapki Apni Party (Peoples),495,0,495,0.3
U05,64,11,ADITI,Independent,151,0,151,0.09
U05,64,12,NOTA,None of the Above,746,7,753,0.45
U05,65,1,NEEL DAMAN KHATRI,Bharatiya Janata Party,68244,589,68833,41.54
U05,65,2,MAHENDER CHAUDHARY,Bahujan Samaj Party,811,10,821,0.5
U05,65,3,SHARAD KUMAR,Aam Aadmi Party,86070,192,86262,52.06
U05,65,4,SIDDHARTH KUNDU,Indian National Congress,6240,30,6270,3.78
U05,65,5,CHAND RAM,Rastriya Aam Jan Seva Party,138,0,138,0.08
U05,65,6,NAR SINGH,Sarvajan Hitay Party,603,1,604,0.36
U05,65,7,RAMESH KUMAR,Bhartiya Samajik Nyay Party,104,1,105,0.06
U05,65,8,RAJBALA SAINI,Loktanter Suraksha Party,1077,5,1082,0.65
U05,65,9,SURESH KUMAR,Peoples Party of India (Democratic),180,0,180,0.11
U05,65,10,SULESH KUMAR,Aapki Apni Party (Peoples),495,0,495,0.3
U05,65,11,ADITI,Independent,151,0,151,0.09
U05,65,12,NOTA,None of the Above,746,7,753,0.45
U05,66,1,NEEL DAMAN KHATRI,Bharatiya Janata Party,68244,589,68833,41.54
U05,66,2,MAHENDER CHAUDHARY,Bahujan Samaj Party,811,10,821,0.5
U05,66,3,SHARAD KUMAR,Aam Aadmi Party,86070,192,86262,52.06
U05,66,4,SIDDHARTH KUNDU,Indian National Congress,6240,30,6270,3.78
U05,66,5,CHAND RAM,Rastriya Aam Jan Seva Party,138,0,138,0.08
U05,66,6,NAR SINGH,Sarvajan Hitay Party,603,1,604,0.36
U05,66,7,RAMESH KUMAR,Bhartiya Samajik Nyay Party,104,1,105,0.06
U05,66,8,RAJBALA SAINI,Loktanter Suraksha Party,1077,5,1082,0.65
U05,66,9,SURESH KUMAR,Peoples Party of India (Democratic),180,0,180,0.11
U05,66,10,SULESH KUMAR,Aapki Apni Party (Peoples),495,0,495,0.3
U05,66,11,ADITI,Independent,151,0,151,0.09
U05,66,12,NOTA,None of the Above,746,7,753,0.45
U05,67,1,NEEL DAMAN KHATRI,Bharatiya Janata Party,68244,589,68833,41.54
U05,67,2,MAHENDER CHAUDHARY,Bahujan Samaj Party,811,10,821,0.5
U05,67,3,SHARAD KUMAR,Aam Aadmi Party,86070,192,86262,52.06
U05,67,4,SIDDHARTH KUNDU,Indian National Congress,6240,30,6270,3.78
U05,67,5,CHAND RAM,Rastriya Aam Jan Seva Party,138,0,138,0.08
U05,67,6,NAR SINGH,Sarvajan Hitay Party,603,1,604,0.36
U05,67,7,RAMESH KUMAR,Bhartiya Samajik Nyay Party,104,1,105,0.06
U05,67,8,RAJBALA SAINI,Loktanter Suraksha Party,1077,5,1082,0.65
U05,67,9,SURESH KUMAR,Peoples Party of India (Democratic),180,0,180,0.11
U05,67,10,SULESH KUMAR,Aapki Apni Party (Peoples),495,0,495,0.3
U05,67,11,ADITI,Independent,151,0,151,0.09
U05,67,12,NOTA,None of the Above,746,7,753,0.45
U05,68,1,NEEL DAMAN KHATRI,Bharatiya Janata Party,68244,589,68833,41.54
U05,68,2,MAHENDER CHAUDHARY,Bahujan Samaj Party,811,10,821,0.5
U05,68,3,SHARAD KUMAR,Aam Aadmi Party,86070,192,86262,52.06
U05,68,4,SIDDHARTH KUNDU,Indian National Congress,6240,30,6270,3.78
U05,68,5,CHAND RAM,Rastriya Aam Jan Seva Party,138,0,138,0.08
U05,68,6,NAR SINGH,Sarvajan Hitay Party,603,1,604,0.36
U05,68,7,RAMESH KUMAR,Bhartiya Samajik Nyay Party,104,1,105,0.06
U05,68,8,RAJBALA SAINI,Loktanter Suraksha Party,1077,5,1082,0.65
U05,68,9,SURESH KUMAR,Peoples Party of India (Democratic),180,0,180,0.11
U05,68,10,SULESH KUMAR,Aapki Apni Party (Peoples),495,0,495,0.3
U05,68,11,ADITI,Independent,151,0,151,0.09
U05,68,12,NOTA,None of the Above,746,7,753,0.45
U05,69,1,NEEL DAMAN KHATRI,Bharatiya Janata Party,68244,589,68833,41.54
U05,69,2,MAHENDER CHAUDHARY,Bahujan Samaj Party,811,10,821,0.5
U05,69,3,SHARAD KUMAR,Aam Aadmi Party,86070,192,86262,52.06
U05,69,4,SIDDHARTH KUNDU,Indian National Congress,6240,30,6270,3.78
U05,69,5,CHAND RAM,Rastriya Aam Jan Seva Party,138,0,138,0.08
U05,69,6,NAR SINGH,Sarvajan Hitay Party,603,1,604,0.36
U05,69,7,RAMESH KUMAR,Bhartiya Samajik Nyay Party,104,1,105,0.06
U05,69,8,RAJBALA SAINI,Loktanter Suraksha Party,1077,5,1082,0.65
U05,69,9,SURESH KUMAR,Peoples Party of India (Democratic),180,0,180,0.11
U05,69,10,SULESH KUMAR,Aapki Apni Party (Peoples),495,0,495,0.3
U05,69,11,ADITI,Independent,151,0,151,0.09
U05,69,12,NOTA,None of the Above,746,7,753,0.45
U05,70,1,NEEL DAMAN KHATRI,Bharatiya Janata Party,68244,589,68833,41.54
U05,70,2,MAHENDER CHAUDHARY,Bahujan Samaj Party,811,10,821,0.5
U05,70,3,SHARAD KUMAR,Aam Aadmi Party,86070,192,86262,52.06
U05,70,4,SIDDHARTH KUNDU,Indian National Congress,6240,30,6270,3.78
U05,70,5,CHAND RAM,Rastriya Aam Jan Seva Party,138,0,138,0.08
U05,70,6,NAR SINGH,Sarvajan Hitay Party,603,1,604,0.36
U05,70,7,RAMESH KUMAR,Bhartiya Samajik Nyay Party,104,1,105,0.06
U05,70,8,RAJBALA SAINI,Loktanter Suraksha Party,1077,5,1082,0.65
U05,70,9,SURESH KUMAR,Peoples Party of India (Democratic),180,0,180,0.11
U05,70,10,SULESH KUMAR,Aapki Apni Party (Peoples),495,0,495,0.3
U05,70,11,ADITI,Independent,151,0,151,0.09
U05,70,12,NOTA,None of the Above,746,7,753,0.45
